R 920 800
NO ./assets/textures/greystone
SO ./assets/textures/bluestone
WE ./assets/textures/redbrick
EA ./assets/textures/colorstone
F 72,80,83
C 72,80,83
SC ./assets/sprites/coin | 1 | 7 | 1 | 5 | 1 | 60 | 1 | 0
        1111111111111111111111111
        1000000000110000000000001
        1011000001110000002000001
        1001000000000000000000001
111111111011000001110000000000001
100000000011000001110111111111111
11110111111111011100000010001
11110111111111011101010010001
1100000000001011100000010001
100020000W0000001100000010001
10000000000000001101010010001
110000011110101111101111000111
11110111 1110101 101111010001
11111111 1111111 111111111111
